Id	id
ClubName	club_name
ClubPhone	club_phone
AltPhone	alt_phone
ClubContact	club_contact
ClubFax	club_fax
ClubEmail	club_email
ClubAddress	club_address
ClubState	club_state
ClubCity	club_city
ClubZip	club_zip
MailingName	mailing_name
MailingAddress	mailing_address
MailingState	mailing_state
MailingZip	mailing_zip
MailingCity	mailing_city
BeginningTime	beginning_time
LastUpdated	last_updated
EnterDate	enter_date
GmName	gm_name
MailingAdress	mailing_adress
CallDay	call_day
PotCallDay	pot_call_day
CallEndTime	call_end_time
ArbitronMarket	arbitron_market
SoundscanMarket	soundscan_market
WalmartStore	walmart_store
WeeklyMark	weekly_mark
ClubOwner	club_owner
AvgAttendance	avg_attendance
CountryMusicNights	country_music_nights
NightsWithDj	nights_with_dj
NightsOpen	nights_open
NightsWithBand	nights_with_band
WebAddress	web_address
RadioAffiliation	radio_affiliation
SsTop100	ss_top_100
DmaTop100	dma_top_100
ClubSize	club_size
ClubCapacity	club_capacity
MusicPlayback	music_playback
DownloadOption	download_option
VideoPlayback	video_playback
VideoFormat	video_format
DanceInstructor	dance_instructor
InstructorName	instructor_name
TableTents	table_tents
CtNapkins	ct_napkins
Venue	venue
OutletType	outlet_type
DmaMarketRank	dma_market_rank
VideoOutlet	video_outlet
ShippingAddress	shipping_address
Hide	hide
Lat	lat
Lon	lon
Category	category
Region	region
GmPhone	gm_phone
GmMethod	gm_method
ContactPhone	contact_phone
GmEmail	gm_email
PrimaryContact	primary_contact
BookingName	booking_name
BookingPhone	booking_phone
BookingEmail	booking_email
BookingMethod	booking_method
InstructorPhone	instructor_phone
InstructorEmail	instructor_email
DjName	dj_name
DjPhone	dj_phone
DjMethod	dj_method
DjEmail	dj_email
InstructorMethod	instructor_method
Distribution	distribution
Reporting	reporting
GmFacebook	gm_facebook
DjFacebook	dj_facebook
BookingFacebook	booking_facebook
InstructorFacebook	instructor_facebook
SecondaryContact	secondary_contact
